9 10
000000L000
0W0WWWWWW0
0WBW0L0GW0
LWLW0WWWWL
0W0W0000W0
0W0WWWW0Wc
0W00C000W0
0WWWWWWWW0
SW000Lb000