9 11
0L000000000
0000WLW00L0
WW0WWCWW000
WWWWWdWWWWW
0LA0bSa0BL0
0WWWWcWWWW0
00EGWDWW000
0WWWWLW0000
eL0000W00L0