9 11
0L000000000
0000WLW00L0
WW0WWCWW000
WWWWWdWWWWW
0LA0bSa0BL0
0WWWWcWWWW0
0WGWWDWW000
0000WLW0000
0L00W0W00L0