10 10
0000L0000G
WWWW00WW00
00WW00WW00
00WW0LWWWW
0000000000
00WWWWWW00
0000WW0000
WW00WW00WW
W0L0WW00L0
S000000000