10 10
0000L0000G
00Z00000L0
0L00000000
00000L0000
Z000000000
000000Z000
0000000000
Z0ZZ000000
00L0Z000L0
S0000000Z0